W W W W W W W W W S W W W W W W W W W
W S S S S W S S S S S S S W S S S S W
W B W W S W S W W W W W S W S W W B W
W S S W S S S S S W S S S S S W S S W
W W S W S W S W S W S W S W S W S W W
S S S S S W S W S W S W S W S S S S S
W W S W S W S W S S S W S W S W S W W
E W S W S W S W W W W W S W S W S W E
W W S W S S S S S S S S S S S W S W W
W S S S S W S W E W E W S W S S S S W
W W S W W W S W 1 E 2 W S W W W S W W
W S S S S W S W W W W W S W S S S S W
W S W W S W S S S S S S S W S W W S W 
W S S W S W S W W W W W S W S W S S W
W W S W S W S S S S S S S W S W S W W
P S S S S S S W S W S W S S S S S S S 
W W S W S W W W S W S W W W S W S W W 
W S S W S S S S S W S S S S S W S S W
W B W W S W S W W W W W S W S W W B W
W S S S S W S S S S S S S W S S S S W
W W W W W W W W W S W W W W W W W W W